{
"af": "ZA",
"am": "ET",
"ar": "AE",
"az": "AZ",
"be": "BY",
"bg": "BG",
"bn": "BD",
"da": "DK",
"de": "DE",
"el": "GR",
"en": "GB",
"es": "ES",
"et": "EE",
"fa": "IR",
"fi": "FI",
"fo": "FO",
"fr": "FR",
"ga": "IE",
"ha": "NG",
"he": "IL",
"hi": "IN",
"hr": "HR",
"hu": "HU",
"hy": "AM",
"id": "ID",
"is": "IS",
"it": "IT",
"iu": "CA",
"ja": "JP",
"ka": "GE",
"kk": "KZ",
"kl": "GL",
"km": "KH",
"ko": "KR",
"ky": "KG",
"lb": "LU",
"lo": "LA",
"lt": "LT",
"lv": "LV",
"mi": "NZ",
"mk": "MK",
"mn": "MN",
"ms": "MY",
"mt": "MT",
"no": "NO",
"ne": "NP",
"nl": "NL",
"pl": "PL",
"ps": "AF",
"pt": "PT",
"qut": "GT",
"ro": "RO",
"ru": "RU",
"rw": "RW",
"si": "LK",
"sk": "SK",
"sl": "SI",
"sq": "AL",
"sr": "BA",
"sr": "CS",
"sv": "SE",
"syr": "SY",
"tg": "TJ",
"th": "TH",
"tk": "TM",
"tr": "TR",
"tzm": "DZ",
"uk": "UA",
"ur": "PK",
"uz": "UZ",
"vi": "VN",
"wo": "SN",
"zh": "CN"
}
